*****************
*               *
*               *
*               *
*               *
*               *
*               *
*               *
*     P M       *
*               *
*               *
*               *
*               *
*               *
*               *
*               *
*****************