*****************
*               *
*               *
*               *
*               *
*               *
*               *
*               *
*       G P     *
*               *
*               *
*               *
*               *
*               *
*               *
*               *
*****************