*****************
*               *
*               *
*               *
*               *
*               *
*               *
*               *
*       J P     *
*               *
*               *
*               *
*               *
*               *
*               *
*               *
*****************