*****************
*               *
*               *
*               *
*               *
*               *
*               *
*               *
*       S P     *
*               *
*               *
*               *
*               *
*               *
*               *
*               *
*****************