*****************
*               *
*               *
*               *
*               *
*               *
*               *
*               *
*     P O       *
*               *
*               *
*               *
*               *
*               *
*               *
*               *
*****************