*****************
*               *
*               *
*               *
*               *
*               *
*               *
*               *
*     P Q       *
*               *
*               *
*               *
*               *
*               *
*               *
*               *
*****************