*****************
*               *
*               *
*               *
*               *
*               *
*               *
*               *
*     P A       *
*               *
*               *
*               *
*               *
*               *
*               *
*               *
*****************