*****************
*               *
*               *
*               *
*               *
*               *
*               *
*               *
*       E P     *
*               *
*               *
*               *
*               *
*               *
*               *
*               *
*****************