*****************
*               *
*               *
*               *
*               *
*               *
*               *
*               *
*     P N       *
*               *
*               *
*               *
*               *
*               *
*               *
*               *
*****************