*****************
*               *
*               *
*               *
*               *
*               *
*     P         *
*               *
*       E       *
*               *
*               *
*               *
*               *
*               *
*               *
*               *
*****************