*****************
*               *
*               *
*               *
*               *
*               *
*               *
*               *
*       T P     *
*               *
*               *
*               *
*               *
*               *
*               *
*               *
*****************