*****************
*               *
*               *
*               *
*               *
*               *
*               *
*               *
*     P D       *
*               *
*               *
*               *
*               *
*               *
*               *
*               *
*****************