*****************
*               *
*               *
*               *
*               *
*               *
*               *
*               *
*       R P     *
*               *
*               *
*               *
*               *
*               *
*               *
*               *
*****************