*****************
*               *
*               *
*               *
*               *
*               *
*               *
*               *
*       Q P     *
*               *
*               *
*               *
*               *
*               *
*               *
*               *
*****************