*****************
*               *
*               *
*               *
*               *
*               *
*       P       *
*               *
*       T       *
*               *
*               *
*               *
*               *
*               *
*               *
*               *
*****************