*****************
*               *
*               *
*               *
*               *
*               *
*               *
*               *
*     P R       *
*               *
*               *
*               *
*               *
*               *
*               *
*               *
*****************