*****************
*               *
*               *
*               *
*               *
*               *
*               *
*               *
*       F P     *
*               *
*               *
*               *
*               *
*               *
*               *
*               *
*****************