*****************
*               *
*               *
*               *
*               *
*               *
*               *
*               *
*       A P     *
*               *
*               *
*               *
*               *
*               *
*               *
*               *
*****************