*****************
*               *
*               *
*               *
*               *
*               *
*               *
*               *
*       N P     *
*               *
*               *
*               *
*               *
*               *
*               *
*               *
*****************