*****************
*               *
*               *
*               *
*               *
*               *
*               *
*               *
*       I P     *
*               *
*               *
*               *
*               *
*               *
*               *
*               *
*****************