*****************
*               *
*               *
*               *
*               *
*               *
*               *
*               *
*     P U       *
*               *
*               *
*               *
*               *
*               *
*               *
*               *
*****************