*****************
*               *
*               *
*               *
*               *
*               *
*               *
*               *
*       K P     *
*               *
*               *
*               *
*               *
*               *
*               *
*               *
*****************