*****************
*               *
*               *
*               *
*               *
*               *
*               *
*               *
*     P S       *
*               *
*               *
*               *
*               *
*               *
*               *
*               *
*****************