*****************
*               *
*               *
*               *
*               *
*               *
*               *
*               *
*     P J       *
*               *
*               *
*               *
*               *
*               *
*               *
*               *
*****************