*****************
*               *
*               *
*               *
*               *
*               *
*               *
*               *
*       H P     *
*               *
*               *
*               *
*               *
*               *
*               *
*               *
*****************