*****************
*               *
*               *
*               *
*               *
*               *
*               *
*               *
*       L P     *
*               *
*               *
*               *
*               *
*               *
*               *
*               *
*****************