*****************
*               *
*               *
*               *
*               *
*               *
*               *
*               *
*       B P     *
*               *
*               *
*               *
*               *
*               *
*               *
*               *
*****************