*****************
*               *
*               *
*               *
*               *
*               *
*               *
*               *
*     P L       *
*               *
*               *
*               *
*               *
*               *
*               *
*               *
*****************