*****************
*               *
*               *
*               *
*               *
*               *
*               *
*               *
*       O P     *
*               *
*               *
*               *
*               *
*               *
*               *
*               *
*****************