*****************
*               *
*               *
*               *
*               *
*               *
*               *
*               *
*       U P     *
*               *
*               *
*               *
*               *
*               *
*               *
*               *
*****************