*****************
*               *
*               *
*               *
*               *
*               *
*               *
*               *
*       D P     *
*               *
*               *
*               *
*               *
*               *
*               *
*               *
*****************