*****************
*               *
*               *
*               *
*               *
*               *
*               *
*               *
*     P H       *
*               *
*               *
*               *
*               *
*               *
*               *
*               *
*****************