*****************
*               *
*               *
*               *
*               *
*               *
*               *
*               *
*       I       *
*               *
*       P       *
*               *
*               *
*               *
*               *
*               *
*****************