*****************
*               *
*               *
*               *
*               *
*               *
*               *
*               *
*       N       *
*               *
*     P         *
*               *
*               *
*               *
*               *
*               *
*****************