*****************
*               *
*               *
*               *
*               *
*               *
*               *
*               *
*       M P     *
*               *
*               *
*               *
*               *
*               *
*               *
*               *
*****************