*****************
*               *
*               *
*               *
*               *
*               *
*               *
*               *
*     P F       *
*               *
*               *
*               *
*               *
*               *
*               *
*               *
*****************