*****************
*               *
*               *
*               *
*               *
*               *
*               *
*               *
*     P K       *
*               *
*               *
*               *
*               *
*               *
*               *
*               *
*****************