*****************
*               *
*               *
*               *
*               *
*               *
*               *
*               *
*     P T       *
*               *
*               *
*               *
*               *
*               *
*               *
*               *
*****************