*****************
*               *
*               *
*               *
*               *
*               *
*               *
*               *
*       G       *
*        P      *
*               *
*               *
*               *
*               *
*               *
*               *
*****************