*****************
*               *
*               *
*               *
*               *
*               *
*               *
*      P        *
*       J       *
*               *
*               *
*               *
*               *
*               *
*               *
*               *
*****************