*****************
*               *
*               *
*               *
*               *
*               *
*               *
*               *
*       F       *
*       P       *
*               *
*               *
*               *
*               *
*               *
*               *
*****************