*****************
*               *
*               *
*               *
*               *
*               *
*               *
*               *
*       H       *
*        P      *
*               *
*               *
*               *
*               *
*               *
*               *
*****************