*****************
*               *
*               *
*               *
*               *
*               *
*               *
*               *
*       CP      *
*               *
*               *
*               *
*               *
*               *
*               *
*               *
*****************