*****************
*               *
*               *
*               *
*               *
*               *
*               *
*               *
*      PJ       *
*               *
*               *
*               *
*               *
*               *
*               *
*               *
*****************