*****************
*               *
*               *
*               *
*               *
*               *
*               *
*               *
*      PE       *
*               *
*               *
*               *
*               *
*               *
*               *
*               *
*****************