*****************
*               *
*               *
*               *
*               *
*               *
*               *
*               *
*       G       *
*      P        *
*               *
*               *
*               *
*               *
*               *
*               *
*****************