*****************
*               *
*               *
*               *
*               *
*               *
*               *
*               *
*       J       *
*        P      *
*               *
*               *
*               *
*               *
*               *
*               *
*****************