*****************
*               *
*               *
*               *
*               *
*               *
*               *
*      P        *
*       I       *
*               *
*               *
*               *
*               *
*               *
*               *
*               *
*****************