*****************
*               *
*               *
*               *
*               *
*               *
*               *
*        P      *
*       D       *
*               *
*               *
*               *
*               *
*               *
*               *
*               *
*****************