*****************
*               *
*               *
*               *
*               *
*               *
*               *
*               *
*       B       *
*      P        *
*               *
*               *
*               *
*               *
*               *
*               *
*****************