*****************
*               *
*               *
*               *
*               *
*               *
*               *
*      P        *
*       B       *
*               *
*               *
*               *
*               *
*               *
*               *
*               *
*****************