*****************
*               *
*               *
*               *
*               *
*               *
*               *
*               *
*     P E       *
*               *
*               *
*               *
*               *
*               *
*               *
*               *
*****************