*****************
*               *
*               *
*               *
*               *
*               *
*               *
*               *
*       EP      *
*               *
*               *
*               *
*               *
*               *
*               *
*               *
*****************