*****************
*               *
*               *
*               *
*               *
*               *
*               *
*               *
*       D       *
*       P       *
*               *
*               *
*               *
*               *
*               *
*               *
*****************