*****************
*               *
*               *
*               *
*               *
*               *
*               *
*        P      *
*       C       *
*               *
*               *
*               *
*               *
*               *
*               *
*               *
*****************