*****************
*               *
*               *
*               *
*               *
*               *
*               *
*               *
*       F       *
*      P        *
*               *
*               *
*               *
*               *
*               *
*               *
*****************