*****************
*               *
*               *
*               *
*               *
*               *
*               *
*        P      *
*       G       *
*               *
*               *
*               *
*               *
*               *
*               *
*               *
*****************