*****************
*               *
*               *
*               *
*               *
*               *
*               *
*      P        *
*       A       *
*               *
*               *
*               *
*               *
*               *
*               *
*               *
*****************