*****************
*               *
*               *
*               *
*               *
*               *
*               *
*               *
*       E       *
*        P      *
*               *
*               *
*               *
*               *
*               *
*               *
*****************