*****************
*               *
*               *
*               *
*               *
*               *
*               *
*               *
*      PG       *
*               *
*               *
*               *
*               *
*               *
*               *
*               *
*****************