*****************
*               *
*               *
*               *
*               *
*               *
*               *
*               *
*      PC       *
*               *
*               *
*               *
*               *
*               *
*               *
*               *
*****************