*****************
*               *
*               *
*               *
*               *
*               *
*               *
*        P      *
*       I       *
*               *
*               *
*               *
*               *
*               *
*               *
*               *
*****************