*****************
*               *
*               *
*               *
*               *
*               *
*               *
*       P       *
*       F       *
*               *
*               *
*               *
*               *
*               *
*               *
*               *
*****************