*****************
*               *
*               *
*               *
*               *
*               *
*               *
*               *
*       HP      *
*               *
*               *
*               *
*               *
*               *
*               *
*               *
*****************