*****************
*               *
*               *
*               *
*               *
*               *
*               *
*               *
*       BP      *
*               *
*               *
*               *
*               *
*               *
*               *
*               *
*****************