*****************
*               *
*               *
*               *
*               *
*               *
*               *
*               *
*       E       *
*               *
*         P     *
*               *
*               *
*               *
*               *
*               *
*****************