*****************
*               *
*               *
*               *
*               *
*               *
*               *
*               *
*       A       *
*      P        *
*               *
*               *
*               *
*               *
*               *
*               *
*****************