*****************
*               *
*               *
*               *
*               *
*               *
*               *
*               *
*       I       *
*      P        *
*               *
*               *
*               *
*               *
*               *
*               *
*****************