*****************
*               *
*               *
*               *
*               *
*               *
*               *
*       P       *
*       C       *
*               *
*               *
*               *
*               *
*               *
*               *
*               *
*****************