*****************
*               *
*               *
*               *
*               *
*               *
*               *
*               *
*       B       *
*        P      *
*               *
*               *
*               *
*               *
*               *
*               *
*****************