*****************
*               *
*               *
*               *
*               *
*               *
*               *
*               *
*       DP      *
*               *
*               *
*               *
*               *
*               *
*               *
*               *
*****************