*****************
*               *
*               *
*               *
*               *
*               *
*               *
*               *
*     P I       *
*               *
*               *
*               *
*               *
*               *
*               *
*               *
*****************