*****************
*               *
*               *
*               *
*               *
*               *
*               *
*       P       *
*       E       *
*               *
*               *
*               *
*               *
*               *
*               *
*               *
*****************