*****************
*               *
*               *
*               *
*               *
*               *
*               *
*               *
*       A       *
*       P       *
*               *
*               *
*               *
*               *
*               *
*               *
*****************