*****************
*               *
*               *
*               *
*               *
*               *
*               *
*               *
*       G       *
*               *
*         P     *
*               *
*               *
*               *
*               *
*               *
*****************