*****************
*               *
*               *
*               *
*               *
*               *
*               *
*      P        *
*       E       *
*               *
*               *
*               *
*               *
*               *
*               *
*               *
*****************