*****************
*               *
*               *
*               *
*               *
*               *
*               *
*               *
*       C       *
*      P        *
*               *
*               *
*               *
*               *
*               *
*               *
*****************