*****************
*               *
*               *
*               *
*               *
*               *
*               *
*               *
*       J       *
*      P        *
*               *
*               *
*               *
*               *
*               *
*               *
*****************