*****************
*               *
*               *
*               *
*               *
*               *
*               *
*               *
*       C       *
*        P      *
*               *
*               *
*               *
*               *
*               *
*               *
*****************