*****************
*               *
*               *
*               *
*               *
*               *
*               *
*               *
*       JP      *
*               *
*               *
*               *
*               *
*               *
*               *
*               *
*****************