*****************
*               *
*               *
*               *
*               *
*               *
*               *
*               *
*       F       *
*        P      *
*               *
*               *
*               *
*               *
*               *
*               *
*****************