*****************
*               *
*               *
*               *
*               *
*               *
*               *
*               *
*     P G       *
*               *
*               *
*               *
*               *
*               *
*               *
*               *
*****************