*****************
*               *
*               *
*               *
*               *
*               *
*               *
*               *
*      PI       *
*               *
*               *
*               *
*               *
*               *
*               *
*               *
*****************