*****************
*               *
*               *
*               *
*               *
*               *
*               *
*        P      *
*       A       *
*               *
*               *
*               *
*               *
*               *
*               *
*               *
*****************