*****************
*               *
*               *
*               *
*               *
*               *
*               *
*               *
*     P B       *
*               *
*               *
*               *
*               *
*               *
*               *
*               *
*****************