*****************
*               *
*               *
*               *
*               *
*               *
*               *
*               *
*       GP      *
*               *
*               *
*               *
*               *
*               *
*               *
*               *
*****************