*****************
*               *
*               *
*               *
*               *
*               *
*               *
*      P        *
*       C       *
*               *
*               *
*               *
*               *
*               *
*               *
*               *
*****************