*****************
*               *
*               *
*               *
*               *
*               *
*               *
*               *
*       H       *
*      P        *
*               *
*               *
*               *
*               *
*               *
*               *
*****************