*****************
*               *
*               *
*               *
*               *
*               *
*               *
*               *
*       E       *
*       P       *
*               *
*               *
*               *
*               *
*               *
*               *
*****************