*****************
*               *
*               *
*               *
*               *
*               *
*               *
*               *
*       C P     *
*               *
*               *
*               *
*               *
*               *
*               *
*               *
*****************