*****************
*               *
*               *
*               *
*               *
*               *
*               *
*       P       *
*       D       *
*               *
*               *
*               *
*               *
*               *
*               *
*               *
*****************