*****************
*               *
*               *
*               *
*               *
*               *
*               *
*               *
*       E       *
*      P        *
*               *
*               *
*               *
*               *
*               *
*               *
*****************