*****************
*               *
*               *
*               *
*               *
*               *
*               *
*        P      *
*       H       *
*               *
*               *
*               *
*               *
*               *
*               *
*               *
*****************