*****************
*               *
*               *
*               *
*               *
*               *
*               *
*      P        *
*       F       *
*               *
*               *
*               *
*               *
*               *
*               *
*               *
*****************