*****************
*               *
*               *
*               *
*               *
*               *
*               *
*      P        *
*       D       *
*               *
*               *
*               *
*               *
*               *
*               *
*               *
*****************