*****************
*               *
*               *
*               *
*               *
*               *
*               *
*       P       *
*       J       *
*               *
*               *
*               *
*               *
*               *
*               *
*               *
*****************