*****************
*               *
*               *
*               *
*               *
*               *
*               *
*               *
*       D       *
*        P      *
*               *
*               *
*               *
*               *
*               *
*               *
*****************