*****************
*               *
*               *
*               *
*               *
*               *
*               *
*       P       *
*       B       *
*               *
*               *
*               *
*               *
*               *
*               *
*               *
*****************