*****************
*               *
*               *
*               *
*               *
*               *
*               *
*               *
*     P C       *
*               *
*               *
*               *
*               *
*               *
*               *
*               *
*****************