*****************
*               *
*               *
*               *
*               *
*               *
*               *
*               *
*       FP      *
*               *
*               *
*               *
*               *
*               *
*               *
*               *
*****************