*****************
*               *
*               *
*               *
*               *
*               *
*               *
*               *
*      PH       *
*               *
*               *
*               *
*               *
*               *
*               *
*               *
*****************