*****************
*               *
*               *
*               *
*               *
*               *
*               *
*               *
*       D       *
*      P        *
*               *
*               *
*               *
*               *
*               *
*               *
*****************