*****************
*               *
*               *
*               *
*               *
*               *
*               *
*               *
*      PF       *
*               *
*               *
*               *
*               *
*               *
*               *
*               *
*****************