*****************
*               *
*               *
*               *
*               *
*               *
*               *
*        P      *
*       F       *
*               *
*               *
*               *
*               *
*               *
*               *
*               *
*****************