*****************
*               *
*               *
*               *
*               *
*               *
*               *
*               *
*       J       *
*       P       *
*               *
*               *
*               *
*               *
*               *
*               *
*****************