*****************
*               *
*               *
*               *
*               *
*               *
*               *
*        P      *
*       J       *
*               *
*               *
*               *
*               *
*               *
*               *
*               *
*****************