*****************
*               *
*               *
*               *
*               *
*               *
*               *
*               *
*       A       *
*        P      *
*               *
*               *
*               *
*               *
*               *
*               *
*****************