*****************
*               *
*               *
*               *
*               *
*               *
*               *
*               *
*       AP      *
*               *
*               *
*               *
*               *
*               *
*               *
*               *
*****************