*****************
*               *
*               *
*               *
*               *
*               *
*               *
*               *
*      PB       *
*               *
*               *
*               *
*               *
*               *
*               *
*               *
*****************