*****************
*               *
*               *
*               *
*               *
*               *
*               *
*      P        *
*       G       *
*               *
*               *
*               *
*               *
*               *
*               *
*               *
*****************