*****************
*               *
*               *
*               *
*               *
*               *
*               *
*        P      *
*       B       *
*               *
*               *
*               *
*               *
*               *
*               *
*               *
*****************