*****************
*               *
*               *
*               *
*               *
*               *
*         P     *
*               *
*       C       *
*               *
*               *
*               *
*               *
*               *
*               *
*               *
*****************