*****************
*               *
*               *
*               *
*               *
*               *
*               *
*               *
*      PA       *
*               *
*               *
*               *
*               *
*               *
*               *
*               *
*****************