*****************
*               *
*               *
*               *
*               *
*               *
*               *
*      P        *
*       H       *
*               *
*               *
*               *
*               *
*               *
*               *
*               *
*****************