*****************
*               *
*               *
*               *
*               *
*               *
*               *
*               *
*      PD       *
*               *
*               *
*               *
*               *
*               *
*               *
*               *
*****************