*****************
*               *
*               *
*               *
*               *
*               *
*               *
*               *
*       I       *
*        P      *
*               *
*               *
*               *
*               *
*               *
*               *
*****************