*****************
*               *
*               *
*               *
*               *
*               *
*               *
*               *
*       IP      *
*               *
*               *
*               *
*               *
*               *
*               *
*               *
*****************