*****************
*               *
*               *
*               *
*               *
*               *
*               *
*        P      *
*       E       *
*               *
*               *
*               *
*               *
*               *
*               *
*               *
*****************